############################################################
#  ##  ##      ##      #         ##          #####         #
#       #  #  ##   ######  ###  ######   ##   #     ##  #  #
#  ##  ##  ####   ##         #       #    ##  #  #   ####  #
#  #    #  ##     #######  ######  #####  #   #  ##     #  #
#  ###     ###   ##   #     #     ##     ##  ##  #####  ####
#       #  ####   #       ###  #      #   ####   #   ####  #
#####  ##   # ##     ##   #    ##  ####  ##      ##   ##   #
#       ##     ###  ##       ###          #  #  ##   ##    #
#   ##  ####  ##    #   ###   ##  ##   #  #  ####   #####  #
#  ##   #     ###   ##  #      ####   #      #     ##      #
####   ###   ##      ####  ##         ###  ##  ######  #   #
#  ##   ###   #####   #     ######  ##          #   #  ##  #
#        ###      #   ####       #  #   ##   #####      ####
#####  #########  #      #########  ##   ##   #     #     ##
#       #      #  #####       #          ########  ##  #   #
#   #########  #   #  ###  ####  ######   ##       #####   #            
#        #     #####          #  #       ##   #  ###   ##  #
#  #  #     #      #  #########  ##  ##  #   ##  ##     #  #
#  #  ####  ####      #  #    #   ####      ######   #     #
#  #   ##     #####   #  #  ####  #     #####   ##   ###   #
#  ##   ####   #####    ##  #     ####  ##     ##   ##     #
####     ##        ###  #  ##  ####     #   ####     ####  #
#     #   ##  #   ##        #        #  ######   ##  #     # 
#  ########   ##   ####  ######  ##  #    ###   ##   #  #  #
#  #   #       ##   ##       ##   #  ###   #   ###   #  #  #
#  #  ###  #    ##   ##  ##   ##  #   #        ###   ####  #
#       ####     #  ##    ##   #  #  ####  ##  ##   ##     #
#   ##   ##   #  #      #  ##     #   ###   ##  ##   #  #  #
############################################################