############################################################
#      #                 #            #                    #
#      #                              #       #######   ####
####   #########         #            #    ####            #
#  #           ###########            #    #               #
#  #                                  #    #  ####         #
#  #           ###########            ######  #  #         #
#              #         #                    #  #         #
#    ###########         ######################  #         #
#    #                                           #         #
#    ######################                      #         #
#                         #######     ########   #######   #
# #############   ######                     #         #   #
#             #   #    #####     ##########  #        ##   #
#             #   #                       #  #        #    #
#####    ######   #             ###########  #######  #  ###
#                 #             #                  #  #  # #
#                 ###########   #                  #  #  # #
#                           #   #                  #       #
#                 ########  #   #                  #       #
#                 #      #  #   #                  #  #  # #
#                 #      #  #   ####################  #  # #
#    #####  #######      #  #                         #  # #
#    #   #  #         ####  ###########    ############  # #
#    #            #####               #    #             ###
#    ##############                   ######               #
#                                                          #
########    #######                   ##  ##               #
#                 #                   #    #               #
############################################################