############################################################
#                                   #      #   #     #     #
#  ###############################  #      #   #     ####  #
#  #         #     #             #  #####  #               #
#  #######   #     ############  #      #  ###########     #
#        #   ####  #        #    #  ##  #            #   ###
#######  #      #           #    #  #   ###########  #     #
#        #   #  ##########  #    #  #             #  ### ###
#######  #   #  #           #### #  #####  #####  #  #     #
#   #    #   #  #           #    #  #   #  #      #  #     #
#   #    #####  ######## ####    #  #   #  #      #  #     #
#   #    #   #              #    #  ##  ########  #  ### ###
#   ##  ##   #############  #              #      #        #
#   #    #   #              ############   #      ##   #####
#   ###  #   ############   #    #         #####           #
#   #                   #        #########     #           #            
#   ###  ############   ######   #             ########    #
#        #          #   #        ############  #           #
####     #####   ####   ######   #        #    ####   ######
#        #          #   #                 #    #  #        #
#####    ############   ################  #    #  ####     #
#   #    #          #    #    #           #    #  #  #  ####
#   #               #    #    #####  #### ###  #  #  #  #  #
#   ##############  #    ###  #                #  #  #  #  #
#                             ###############  #  #  #  ####
####################  #####   #                #           #
#               #         #   ###############  ######   ####
#############   ######    #   #      #      #  #    #      #
#                                           #              #
############################################################