############################################################
#                            #   #      #                  #
#                     ###  ###  ######  ##                 #
#                            #       #   ###               #
#                           ##       ##   #   #  ##        #
#                           #      #####  #  ##  #         #
#                           #  #          #####  #         #
#                              #   ########      ##   ##   #
#                            ###         #   #  ##   ##    #
#   ##  ####           ####    #  #  #   #  #####   ###### #
#####   #              #       ####  #      #      ##      #
#  #  ###            ###  ###        ###  ###  ######  #   #
###################   #     ######  ##          #   #  #   #
#   #             #   ####       #  #   ##   #####     #####
#####  #########  #      #########  ##   ##   #      ##    #
#       #      #  #####       #           #####     #      #
#   #########  #      #########  ######   #                #
#              #####          #  #       ##  #######       #
#  #  #  ###       #########  #  ##   #  #                 #
####  #    #####              #   #####                    #
#     ###      #  #   ##########  #                        #
#       ####   ####      #  #     #####                    #
#                    ##  #  #  ####                        #
#                #####      #                              #
#                        ######                          ###
#                                              ##  ######  #
#                                        ##    #      #    #
#                                       ##   ###  #####  ###
#                                      ##   #         #  # #
############################################################
